20 20
16 9 0
1
0 0 0 0.75
2 2 2 2 2 2 2 2 2 2 2 2 2 2 2 2 2 2 2 2
2 1 0 0 0 0 0 0 0 0 0 0 0 -1 -1 -1 -1 -1 1 2
2 1 0 2 2 2 2 1 1 1 0 0 0 -1 -1 -1 -1 -1 1 2
2 1 0 0 0 0 0 0 0 0 0 0 0 -1 -1 -1 -1 -1 1 2
2 1 0 0 1 1 1 1 1 0 0 0 0 -1 -1 -1 -1 -1 1 2
2 1 0 0 2 2 2 2 1 0 0 0 0 -1 -1 -1 -1 -1 1 2
2 1 0 0 0 0 0 0 0 0 0 0 0 0 0 0 0 0 1 2
2 1 0 0 2 2 2 2 1 2 0 0 0 0 0 0 0 0 1 2
2 1 0 0 0 0 0 2 0 2 0 0 0 0 0 0 0 0 1 2
2 1 0 0 0 0 0 2 1 2 0 0 0 0 0 0 0 0 1 2
2 1 0 0 0 0 0 2 0 2 0 0 0 0 0 0 0 0 1 2
2 1 0 0 0 0 0 0 0 0 0 0 0 0 0 0 0 0 1 2
2 1 0 0 0 0 0 0 0 0 0 0 0 0 0 0 0 0 1 2
2 1 0 0 0 0 0 0 0 0 0 0 0 0 0 0 0 0 1 2
2 1 0 0 0 0 0 0 0 0 0 0 0 0 0 0 0 0 1 2
2 1 0 0 0 0 0 0 0 0 0 0 0 0 0 0 0 0 1 2
2 1 0 0 0 0 0 0 0 0 0 0 0 0 0 0 0 0 1 2
2 1 0 0 0 0 0 0 0 0 0 0 0 0 0 0 0 0 1 2
2 1 0 0 0 0 0 0 0 0 0 0 0 0 0 0 0 0 1 2
2 2 2 2 2 2 2 2 2 2 2 2 2 2 2 2 2 2 2 2
3 13 3
2 15 3
1 3 17
1 6 17
1 3 14
1 6 14